AAL	Europe/Copenhagen	Aalborg Airport	Aalborg
AAR	Europe/Copenhagen	Aarhus Airport	Aarhus
ABE	America/New_York	Lehigh Valley International Airport	Allentown
ABJ	Africa/Abidjan	Port Bouet Airport	Abidjan
ABQ	America/Denver	Albuquerque International Sunport	Albuquerque
ABS	Africa/Cairo	Abu Simbel Airport	Abu Simbel
ABV	Africa/Lagos	Nnamdi Azikiwe International Airport	Abuja
ABZ	Europe/London	Aberdeen Dyce Airport	Aberdeen
ACA	America/Mexico_City	General Juan N Alvarez International Airport	Acapulco
ACC	Africa/Accra	Kotoka International Airport	Accra
ACE	Atlantic/Canary	Lanzarote Airport	Lanzarote Island
ACH	Europe/Zurich	St Gallen Altenrhein Airport	Altenrhein
ACK	America/New_York	Nantucket Memorial Airport	Nantucket
ACV	America/Los_Angeles	California Redwood Coast-Humboldt County Airport	Arcata/Eureka
ADA	Europe/Istanbul	Adana Airport	Adana
ADB	Europe/Istanbul	Adnan Menderes International Airport	Izmir
ADD	Africa/Addis_Ababa	Addis Ababa Bole International Airport	Addis Ababa
ADF	Europe/Istanbul	Adiyaman Airport	Adiyaman
ADL	Australia/Adelaide	Adelaide International Airport	Adelaide
AER	Europe/Moscow	Sochi International Airport	Sochi
AES	Europe/Oslo	Alesund Airport	Alesund
AGH	Europe/Stockholm	Angelholm-Helsingborg Airport	Angelholm
AGP	Europe/Madrid	Malaga Airport	Malaga
AGS	America/New_York	Augusta Regional At Bush Field	Augusta
AHO	Europe/Rome	Alghero-Fertilia Airport	Alghero
AJI	Europe/Istanbul	Agri Airport	
AKJ	Asia/Tokyo	Asahikawa Airport	Asahikawa / Hokkaido
AKL	Pacific/Auckland	Auckland International Airport	Auckland
ALA	Asia/Almaty	Almaty Airport	Almaty
ALB	America/New_York	Albany International Airport	Albany
ALC	Europe/Madrid	Alicante International Airport	Alicante
ALF	Europe/Oslo	Alta Airport	Alta
ALG	Africa/Algiers	Houari Boumediene Airport	Algiers
ALP	Asia/Damascus	Aleppo International Airport	Aleppo
ALY	Africa/Cairo	El Nouzha Airport	Alexandria
AMD	Asia/Kolkata	Sardar Vallabhbhai Patel International Airport	Ahmedabad
AMM	Asia/Amman	Queen Alia International Airport	Amman
AMS	Europe/Amsterdam	Amsterdam Airport Schiphol	Amsterdam
ANC	America/Anchorage	Ted Stevens Anchorage International Airport	Anchorage
ANU	America/Antigua	V.C. Bird International Airport	St. John's
AOE	Europe/Istanbul	Anadolu Airport	Eskisehir
AOI	Europe/Rome	Ancona Falconara Airport	Ancona
AOK	Europe/Athens	Karpathos Airport	Karpathos Island
AOO	America/New_York	Altoona Blair County Airport	Altoona
APW	Pacific/Apia	Faleolo International Airport	Apia
ARN	Europe/Stockholm	Stockholm-Arlanda Airport	Stockholm
ASB	Asia/Ashgabat	Ashgabat International Airport	Ashgabat
ASE	America/Denver	Aspen-Pitkin Co/Sardy Field	Aspen
ASM	Africa/Asmara	Asmara International Airport	Asmara
ASR	Europe/Istanbul	Kayseri Erkilet Airport	Kayseri
ASW	Africa/Cairo	Aswan International Airport	Aswan
ATH	Europe/Athens	Eleftherios Venizelos International Airport	Athens
ATL	America/New_York	Hartsfield Jackson Atlanta International Airport	Atlanta
ATW	America/Chicago	Appleton International Airport	Appleton
ATZ	Africa/Cairo	Assiut International Airport	Assiut
AUA	America/Aruba	Queen Beatrix International Airport	Oranjestad
AUG	America/New_York	Augusta State Airport	Augusta
AUH	Asia/Dubai	Abu Dhabi International Airport	Abu Dhabi
AUS	America/Chicago	Austin Bergstrom International Airport	Austin
AVL	America/New_York	Asheville Regional Airport	Asheville
AVP	America/New_York	Wilkes Barre Scranton International Airport	Wilkes-Barre/Scranton
AXT	Asia/Tokyo	Akita Airport	Akita
AYT	Europe/Istanbul	Antalya International Airport	Antalya
AZS	America/Santo_Domingo	Samana El Catey International Airport	Samana
BAH	Asia/Bahrain	Bahrain International Airport	Manama
BAL	Europe/Istanbul	Batman Airport	Batman
BAV	Asia/Shanghai	Baotou Airport	Baotou
BCN	Europe/Madrid	Barcelona International Airport	Barcelona
BDA	Atlantic/Bermuda	L.F. Wade International International Airport	Hamilton
BDL	America/New_York	Bradley International Airport	Hartford
BEG	Europe/Belgrade	Belgrade Nikola Tesla Airport	Belgrade
BEN	Africa/Tripoli	Benina International Airport	Benghazi
BEY	Asia/Beirut	Beirut Rafic Hariri International Airport	Beirut
BFL	America/Los_Angeles	Meadows Field	Bakersfield
BGI	America/Barbados	Grantley Adams International Airport	Bridgetown
BGM	America/New_York	Greater Binghamton/Edwin A Link field	Binghamton
BGO	Europe/Oslo	Bergen Airport Flesland	Bergen
BGR	America/New_York	Bangor International Airport	Bangor
BGW	Asia/Baghdad	Baghdad International Airport	Baghdad
BHB	America/New_York	Hancock County-Bar Harbor Airport	Bar Harbor
BHD	Europe/London	George Best Belfast City Airport	Belfast
BHE	Pacific/Auckland	Woodbourne Airport	Blenheim
BHM	America/Chicago	Birmingham-Shuttlesworth International Airport	Birmingham
BHX	Europe/London	Birmingham International Airport	Birmingham
BHY	Asia/Shanghai	Beihai Airport	Beihai
BIA	Europe/Paris	Bastia-Poretta Airport	Bastia/Poretta
BIL	America/Denver	Billings Logan International Airport	Billings
BIO	Europe/Madrid	Bilbao Airport	Bilbao
BIQ	Europe/Paris	Biarritz-Anglet-Bayonne Airport	Biarritz/Anglet/Bayonne
BIS	America/Chicago	Bismarck Municipal Airport	Bismarck
BJL	Africa/Banjul	Banjul International Airport	Banjul
BJV	Europe/Istanbul	Milas Bodrum International Airport	Bodrum
BKI	Asia/Kuching	Kota Kinabalu International Airport	Kota Kinabalu
BKK	Asia/Bangkok	Suvarnabhumi Airport	Bangkok
BKW	America/New_York	Raleigh County Memorial Airport	Beckley
BLL	Europe/Copenhagen	Billund Airport	Billund
BLQ	Europe/Rome	Bologna Guglielmo Marconi Airport	Bologna
BLR	Asia/Kolkata	Kempegowda International Airport	Bangalore
BLZ	Africa/Blantyre	Chileka International Airport	Blantyre
BNA	America/Chicago	Nashville International Airport	Nashville
BNE	Australia/Brisbane	Brisbane International Airport	Brisbane
BOG	America/Bogota	El Dorado International Airport	Bogota
BOI	America/Boise	Boise Air Terminal/Gowen Field	Boise
BOM	Asia/Kolkata	Chhatrapati Shivaji International Airport	Mumbai
BOO	Europe/Oslo	Bodo Airport	Bodo
BOS	America/New_York	General Edward Lawrence Logan International Airport	Boston
BPX	Asia/Urumqi	Qamdo Bangda Airport	Bangda
BRE	Europe/Berlin	Bremen Airport	Bremen
BRI	Europe/Rome	Bari Karol Wojtyla Airport	Bari
BRN	Europe/Zurich	Bern Belp Airport	Bern
BRU	Europe/Brussels	Brussels Airport	Brussels
BSB	America/Sao_Paulo	Presidente Juscelino Kubistschek International Airport	Brasilia
BSL	Europe/Paris	EuroAirport Basel-Mulhouse-Freiburg Airport	Bale/Mulhouse
BTV	America/New_York	Burlington International Airport	Burlington
BUD	Europe/Budapest	Budapest Liszt Ferenc International Airport	Budapest
BUF	America/New_York	Buffalo Niagara International Airport	Buffalo
BUR	America/Los_Angeles	Bob Hope Airport	Burbank
BUS	Asia/Tbilisi	Batumi International Airport	Batumi
BWI	America/New_York	Baltimore/Washington International Thurgood Marshall Airport	Baltimore
BWK	Europe/Zagreb	Bol Airport	Brac Island
BWN	Asia/Brunei	Brunei International Airport	Bandar Seri Begawan
BZE	America/Belize	Philip S. W. Goldson International Airport	Belize City
BZN	America/Denver	Gallatin Field	Bozeman
CAE	America/New_York	Columbia Metropolitan Airport	Columbia
CAG	Europe/Rome	Cagliari Elmas Airport	Cagliari
CAI	Africa/Cairo	Cairo International Airport	Cairo
CAK	America/New_York	Akron Canton Regional Airport	Akron
CAN	Asia/Shanghai	Guangzhou Baiyun International Airport	Guangzhou
CCC	America/Havana	Jardines Del Rey Airport	Cayo Coco
CCS	America/Caracas	Simon Bolivar International Airport	Caracas
CCU	Asia/Kolkata	Netaji Subhash Chandra Bose International Airport	Kolkata
CDG	Europe/Paris	Charles de Gaulle International Airport	Paris
CEB	Asia/Manila	Mactan Cebu International Airport	Lapu-Lapu City
CEC	America/Los_Angeles	Jack Mc Namara Field Airport	Crescent City
CEI	Asia/Bangkok	Chiang Rai International Airport	Chiang Rai
CFU	Europe/Athens	Ioannis Kapodistrias International Airport	Kerkyra Island
CGK	Asia/Jakarta	Soekarno-Hatta International Airport	Jakarta
CGN	Europe/Berlin	Cologne Bonn Airport	Cologne
CGO	Asia/Shanghai	Zhengzhou Xinzheng International Airport	Zhengzhou
CGQ	Asia/Shanghai	Longjia Airport	Changchun
CHA	America/New_York	Lovell Field	Chattanooga
CHC	Pacific/Auckland	Christchurch International Airport	Christchurch
CHO	America/New_York	Charlottesville Albemarle Airport	Charlottesville
CHQ	Europe/Athens	Chania International Airport	Souda
CHS	America/New_York	Charleston Air Force Base-International Airport	Charleston
CIC	America/Los_Angeles	Chico Municipal Airport	Chico
CID	America/Chicago	The Eastern Iowa Airport	Cedar Rapids
CIF	Asia/Shanghai	Chifeng Airport	Chifeng
CIH	Asia/Shanghai	Changzhi Airport	Changzhi
CJJ	Asia/Seoul	Cheongju International Airport/Cheongju Air Base (K-59/G-513)	Cheongju
CJU	Asia/Seoul	Jeju International Airport	Jeju City
CKB	America/New_York	North Central West Virginia Airport	Clarksburg
CKG	Asia/Shanghai	Chongqing Jiangbei International Airport	Chongqing
CKZ	Europe/Istanbul	Canakkale Airport	Canakkale
CLD	America/Los_Angeles	Mc Clellan-Palomar Airport	Carlsbad
CLE	America/New_York	Cleveland Hopkins International Airport	Cleveland
CLJ	Europe/Bucharest	Cluj-Napoca International Airport	Cluj-Napoca
CLT	America/New_York	Charlotte Douglas International Airport	Charlotte
CMB	Asia/Colombo	Bandaranaike International Colombo Airport	Colombo
CMH	America/New_York	John Glenn Columbus International Airport	Columbus
CMN	Africa/Casablanca	Mohammed V International Airport	Casablanca
CNF	America/Sao_Paulo	Tancredo Neves International Airport	Belo Horizonte
CNS	Australia/Brisbane	Cairns International Airport	Cairns
CNX	Asia/Bangkok	Chiang Mai International Airport	Chiang Mai
COD	America/Denver	Yellowstone Regional Airport	Cody
COS	America/Denver	City of Colorado Springs Municipal Airport	Colorado Springs
CPH	Europe/Copenhagen	Copenhagen Kastrup Airport	Copenhagen
CPR	America/Denver	Casper-Natrona County International Airport	Casper
CPT	Africa/Johannesburg	Cape Town International Airport	Cape Town
CRK	Asia/Manila	Diosdado Macapagal International Airport	Angeles/Mabalacat
CRW	America/New_York	Yeager Airport	Charleston
CSX	Asia/Shanghai	Changsha Huanghua International Airport	Changsha
CTA	Europe/Rome	Catania-Fontanarossa Airport	Catania
CTS	Asia/Tokyo	New Chitose Airport	Chitose / Tomakomai
CTU	Asia/Shanghai	Chengdu Shuangliu International Airport	Chengdu
CUN	America/Cancun	Cancun International Airport	Cancun
CVG	America/New_York	Cincinnati Northern Kentucky International Airport	Cincinnati
CWA	America/Chicago	Central Wisconsin Airport	Mosinee
CZM	America/Cancun	Cozumel International Airport	Cozumel
CZX	Asia/Shanghai	Changzhou Benniu Airport	Changzhou
DAB	America/New_York	Daytona Beach International Airport	Daytona Beach
DAC	Asia/Dhaka	Hazrat Shahjalal International Airport	Dhaka
DAM	Asia/Damascus	Damascus International Airport	Damascus
DAR	Africa/Dar_es_Salaam	Julius Nyerere International Airport	Dar es Salaam
DAT	Asia/Shanghai	Datong Airport	Datong
DAX	Asia/Shanghai	Dachuan Airport	Dazhou
DAY	America/New_York	James M Cox Dayton International Airport	Dayton
DBV	Europe/Zagreb	Dubrovnik Airport	Dubrovnik
DCA	America/New_York	Ronald Reagan Washington National Airport	Washington
DDG	Asia/Shanghai	Dandong Airport	Dandong
DEL	Asia/Kolkata	Indira Gandhi International Airport	New Delhi
DEN	America/Denver	Denver International Airport	Denver
DFW	America/Chicago	Dallas Fort Worth International Airport	Dallas-Fort Worth
DIY	Europe/Istanbul	Diyarbakir Airport	Diyarbakir
DJE	Africa/Tunis	Djerba Zarzis International Airport	Djerba
DKR	Africa/Dakar	Leopold Sedar Senghor International Airport	Dakar
DLA	Africa/Douala	Douala International Airport	Douala
DLC	Asia/Shanghai	Zhoushuizi Airport	Dalian
DLM	Europe/Istanbul	Dalaman International Airport	Dalaman
DME	Europe/Moscow	Domodedovo International Airport	Moscow
DMM	Asia/Riyadh	King Fahd International Airport	Ad Dammam
DNH	Asia/Urumqi	Dunhuang Airport	Dunhuang
DNK	Europe/Zaporozhye	Dnipropetrovsk International Airport	Dnipropetrovsk
DNZ	Europe/Istanbul	Cardak Airport	Denizli
DOH	Asia/Qatar	Hamad International Airport	Doha
DOK	Europe/Zaporozhye	Donetsk International Airport	Donetsk
DPS	Asia/Makassar	Ngurah Rai (Bali) International Airport	Denpasar-Bali Island
DRO	America/Denver	Durango La Plata County Airport	Durango
DRS	Europe/Berlin	Dresden Airport	Dresden
DSM	America/Chicago	Des Moines International Airport	Des Moines
DSN	Asia/Shanghai	Ordos Ejin Horo Airport	Ordos
DTW	America/Detroit	Detroit Metropolitan Wayne County Airport	Detroit
DUB	Europe/Dublin	Dublin Airport	Dublin
DUD	Pacific/Auckland	Dunedin Airport	Dunedin
DUR	Africa/Johannesburg	King Shaka International Airport	Durban
DUS	Europe/Berlin	Dusseldorf Airport	Dusseldorf
DXB	Asia/Dubai	Dubai International Airport	Dubai
DYG	Asia/Shanghai	Dayong Airport	Dayong
DYU	Asia/Dushanbe	Dushanbe Airport	Dushanbe
EBB	Africa/Kampala	Entebbe International Airport	Kampala
EBJ	Europe/Copenhagen	Esbjerg Airport	Esbjerg
EBL	Asia/Baghdad	Erbil International Airport	Arbil
ECN	Asia/Nicosia	Ercan International Airport	Nicosia
EDI	Europe/London	Edinburgh Airport	Edinburgh
EFL	Europe/Athens	Kefallinia Airport	Kefallinia Island
ELM	America/New_York	Elmira Corning Regional Airport	Elmira/Corning
ELP	America/Denver	El Paso International Airport	El Paso
ELS	Africa/Johannesburg	Ben Schoeman Airport	East London
EMA	Europe/London	East Midlands Airport	Nottingham
ENY	Asia/Shanghai	Yan'an Ershilipu Airport	Yan'an
ERC	Europe/Istanbul	Erzincan Airport	Erzincan
ERF	Europe/Berlin	Erfurt Airport	Erfurt
ERI	America/New_York	Erie International Tom Ridge Field	Erie
ERZ	Europe/Istanbul	Erzurum International Airport	Erzurum
ESB	Europe/Istanbul	Esenboga International Airport	Ankara
EUG	America/Los_Angeles	Mahlon Sweet Field	Eugene
EVE	Europe/Oslo	Harstad/Narvik Airport	NO-18
EVN	Asia/Yerevan	Zvartnots International Airport	Yerevan
EWN	America/New_York	Coastal Carolina Regional Airport	New Bern
EWR	America/New_York	Newark Liberty International Airport	Newark
EYW	America/New_York	Key West International Airport	Key West
EZE	America/Argentina/Buenos_Aires	Ministro Pistarini International Airport	Buenos Aires
EZS	Europe/Istanbul	Elazig Airport	Elazig
FAO	Europe/Lisbon	Faro Airport	Faro
FAR	America/Chicago	Hector International Airport	Fargo
FAT	America/Los_Angeles	Fresno Yosemite International Airport	Fresno
FAY	America/New_York	Fayetteville Regional Grannis Field	Fayetteville
FCA	America/Denver	Glacier Park International Airport	Kalispell
FCO	Europe/Rome	Leonardo da Vinci-Fiumicino Airport	Rome
FDF	America/Martinique	Martinique Aime Cesaire International Airport	Fort-de-France
FDH	Europe/Berlin	Friedrichshafen Airport	Friedrichshafen
FIH	Africa/Kinshasa	Ndjili International Airport	Kinshasa
FKS	Asia/Tokyo	Fukushima Airport	Sukagawa
FLG	America/Phoenix	Flagstaff Pulliam Airport	Flagstaff
FLL	America/New_York	Fort Lauderdale Hollywood International Airport	Fort Lauderdale
FLO	America/New_York	Florence Regional Airport	Florence
FLR	Europe/Rome	Peretola Airport	Firenze
FMO	Europe/Berlin	Munster Osnabruck Airport	Munster
FNA	Africa/Freetown	Lungi International Airport	Freetown
FNC	Atlantic/Madeira	Madeira Airport	Funchal
FNJ	Asia/Pyongyang	Pyongyang Sunan International Airport	Pyongyang
FOC	Asia/Shanghai	Fuzhou Changle International Airport	Fuzhou
FOR	America/Fortaleza	Pinto Martins International Airport	Fortaleza
FPO	America/Nassau	Grand Bahama International Airport	Freeport
FRA	Europe/Berlin	Frankfurt am Main Airport	Frankfurt am Main
FRU	Asia/Bishkek	Manas International Airport	Bishkek
FSD	America/Chicago	Joe Foss Field Airport	Sioux Falls
FSZ	Asia/Tokyo	Mt. Fuji Shizuoka Airport	Makinohara / Shimada
FUE	Atlantic/Canary	Fuerteventura Airport	Fuerteventura Island
FUJ	Asia/Tokyo	Fukue Airport	Goto
FUK	Asia/Tokyo	Fukuoka Airport	Fukuoka
FWA	America/Indiana/Indianapolis	Fort Wayne International Airport	Fort Wayne
GBE	Africa/Gaborone	Sir Seretse Khama International Airport	Gaborone
GCC	America/Denver	Gillette Campbell County Airport	Gillette
GCM	America/Cayman	Owen Roberts International Airport	Georgetown
GDL	America/Mexico_City	Don Miguel Hidalgo Y Costilla International Airport	Guadalajara
GDN	Europe/Warsaw	Gdansk Lech Walesa Airport	Gdansk
GEG	America/Los_Angeles	Spokane International Airport	Spokane
GIG	America/Sao_Paulo	Rio Galeao - Tom Jobim International Airport	Rio De Janeiro
GIS	Pacific/Auckland	Gisborne Airport	Gisborne
GJT	America/Denver	Grand Junction Regional Airport	Grand Junction
GLA	Europe/London	Glasgow International Airport	Glasgow
GMP	Asia/Seoul	Gimpo International Airport	Seoul
GNV	America/New_York	Gainesville Regional Airport	Gainesville
GNY	Europe/Istanbul	Sanliurfa GAP Airport	Sanliurfa
GOA	Europe/Rome	Genoa Cristoforo Colombo Airport	Genova
GOJ	Europe/Moscow	Nizhny Novgorod Strigino International Airport	Nizhny Novgorod
GOT	Europe/Stockholm	Gothenburg-Landvetter Airport	Gothenburg
GPT	America/Chicago	Gulfport Biloxi International Airport	Gulfport
GRB	America/Chicago	Austin Straubel International Airport	Green Bay
GRQ	Europe/Amsterdam	Eelde Airport	Groningen
GRR	America/Detroit	Gerald R. Ford International Airport	Grand Rapids
GRU	America/Sao_Paulo	Guarulhos - Governador Andre Franco Montoro International Airport	Sao Paulo
GRX	Europe/Madrid	Federico Garcia Lorca Airport	Granada
GRZ	Europe/Vienna	Graz Airport	Graz
GSO	America/New_York	Piedmont Triad International Airport	Greensboro
GSP	America/New_York	Greenville Spartanburg International Airport	Greenville
GTF	America/Denver	Great Falls International Airport	Great Falls
GUC	America/Denver	Gunnison Crested Butte Regional Airport	Gunnison
GVA	Europe/Zurich	Geneva Cointrin International Airport	Geneva
GWT	Europe/Berlin	Westerland Sylt Airport	Westerland
GYD	Asia/Baku	Heydar Aliyev International Airport	Baku
GYM	America/Hermosillo	General Jose Maria Yanez International Airport	Guaymas
GYS	Asia/Shanghai	Guangyuan Airport	Guangyuan
GZT	Europe/Istanbul	Gaziantep International Airport	Gaziantep
HAC	Asia/Tokyo	Hachijojima Airport	Hachijojima
HAJ	Europe/Berlin	Hannover Airport	Hannover
HAK	Asia/Shanghai	Haikou Meilan International Airport	Haikou
HAM	Europe/Berlin	Hamburg Airport	Hamburg
HAN	Asia/Ho_Chi_Minh	Noi Bai International Airport	Hanoi
HAU	Europe/Oslo	Haugesund Airport	Karmoy
HAV	America/Havana	Jose Marti International Airport	Havana
HBE	Africa/Cairo	Borg El Arab International Airport	Alexandria
HDN	America/Denver	Yampa Valley Airport	Hayden
HDY	Asia/Bangkok	Hat Yai International Airport	Hat Yai
HEL	Europe/Helsinki	Helsinki Vantaa Airport	Helsinki
HER	Europe/Athens	Heraklion International Nikos Kazantzakis Airport	Heraklion
HET	Asia/Shanghai	Baita International Airport	Hohhot
HFE	Asia/Shanghai	Hefei Luogang International Airport	Hefei
HGH	Asia/Shanghai	Hangzhou Xiaoshan International Airport	Hangzhou
HGN	Asia/Bangkok	Mae Hong Son Airport	
HHH	America/New_York	Hilton Head Airport	Hilton Head Island
HIJ	Asia/Tokyo	Hiroshima Airport	Hiroshima
HIN	Asia/Seoul	Sacheon Air Base/Airport	Sacheon
HKD	Asia/Tokyo	Hakodate Airport	Hakodate
HKG	Asia/Hong_Kong	Hong Kong International Airport	Hong Kong
HKK	Pacific/Auckland	Hokitika Airfield	
HKT	Asia/Bangkok	Phuket International Airport	Phuket
HLD	Asia/Shanghai	Dongshan Airport	Hailar
HLN	America/Denver	Helena Regional Airport	Helena
HLZ	Pacific/Auckland	Hamilton International Airport	Hamilton
HMO	America/Hermosillo	General Ignacio P. Garcia International Airport	Hermosillo
HND	Asia/Tokyo	Tokyo Haneda International Airport	Tokyo
HNL	Pacific/Honolulu	Daniel K Inouye International Airport	Honolulu
HOG	America/Havana	Frank Pais International Airport	Holguin
HOQ	Europe/Berlin	Hof-Plauen Airport	Hof
HOR	Atlantic/Azores	Horta Airport	Horta
HPN	America/New_York	Westchester County Airport	White Plains
HRB	Asia/Shanghai	Taiping Airport	Harbin
HRE	Africa/Harare	Robert Gabriel Mugabe International Airport	Harare
HRG	Africa/Cairo	Hurghada International Airport	Hurghada
HRK	Europe/Zaporozhye	Kharkiv International Airport	Kharkiv
HSG	Asia/Tokyo	Saga Airport	Saga
HSV	America/Chicago	Huntsville International Carl T Jones Field	Huntsville
HTA	Asia/Yakutsk	Chita-Kadala Airport	Chita
HTN	Asia/Shanghai	Hotan Airport	Hotan
HTS	America/New_York	Tri-State/Milton J. Ferguson Field	Huntington
HTY	Europe/Istanbul	Hatay Airport	Hatay
HVN	America/New_York	Tweed New Haven Airport	New Haven
HYA	America/New_York	Barnstable Municipal Boardman Polando Field	Hyannis
HYD	Asia/Kolkata	Rajiv Gandhi International Airport	Hyderabad
HYN	Asia/Shanghai	Huangyan Luqiao Airport	Huangyan
IAD	America/New_York	Washington Dulles International Airport	Washington
IAH	America/Chicago	George Bush Intercontinental Houston Airport	Houston
IAS	Europe/Bucharest	Iasi Airport	Iasi
IBZ	Europe/Madrid	Ibiza Airport	Ibiza
ICN	Asia/Seoul	Incheon International Airport	Seoul
ICT	America/Chicago	Wichita Eisenhower National Airport	Wichita
IDA	America/Boise	Idaho Falls Regional Airport	Idaho Falls
IKA	Asia/Tehran	Imam Khomeini International Airport	Tehran
ILM	America/New_York	Wilmington International Airport	Wilmington
INC	Asia/Shanghai	Yinchuan Hedong International Airport	Yinchuan
IND	America/Indiana/Indianapolis	Indianapolis International Airport	Indianapolis
INN	Europe/Vienna	Innsbruck Airport	Innsbruck
INV	Europe/London	Inverness Airport	Inverness
IPL	America/Los_Angeles	Imperial County Airport	Imperial
IPT	America/New_York	Williamsport Regional Airport	Williamsport
ISB	Asia/Karachi	Islamabad International Airport	Islamabad
ISG	Asia/Tokyo	New Ishigaki Airport	Ishigaki
ISP	America/New_York	Long Island Mac Arthur Airport	Islip
IST	Europe/Istanbul	Istanbul Airport	Istanbul
ITH	America/New_York	Ithaca Tompkins Regional Airport	Ithaca
ITM	Asia/Tokyo	Osaka International Airport	Osaka
IUE	Pacific/Niue	Niue International Airport	Alofi
IVC	Pacific/Auckland	Invercargill Airport	Invercargill
IWJ	Asia/Tokyo	Iwami Airport	Masuda
IYK	America/Los_Angeles	Inyokern Airport	Inyokern
JAC	America/Denver	Jackson Hole Airport	Jackson
JAN	America/Chicago	Jackson-Medgar Wiley Evers International Airport	Jackson
JAX	America/New_York	Jacksonville International Airport	Jacksonville
JDZ	Asia/Shanghai	Jingdezhen Airport	Jingdezhen
JED	Asia/Riyadh	King Abdulaziz International Airport	Jeddah
JER	Europe/Jersey	Jersey Airport	Saint Helier
JFK	America/New_York	John F Kennedy International Airport	New York
JGN	Asia/Shanghai	Jiayuguan Airport	Jiayuguan
JGS	Asia/Shanghai	Jinggangshan Airport	Ji'an
JHG	Asia/Shanghai	Xishuangbanna Gasa Airport	Jinghong
JIU	Asia/Shanghai	Jiujiang Lushan Airport	Jiujiang
JJN	Asia/Shanghai	Quanzhou Jinjiang International Airport	Quanzhou
JMK	Europe/Athens	Mikonos Airport	Mykonos Island
JMU	Asia/Shanghai	Jiamusi Airport	Jiamusi
JNB	Africa/Johannesburg	OR Tambo International Airport	Johannesburg
JNG	Asia/Shanghai	Jining Qufu Airport	Jining
JNZ	Asia/Shanghai	Jinzhou Airport	Jinzhou
JSI	Europe/Athens	Skiathos Island National Airport	Skiathos
JST	America/New_York	John Murtha Johnstown Cambria County Airport	Johnstown
JTR	Europe/Athens	Santorini Airport	Santorini Island
JZH	Asia/Shanghai	Jiuzhai Huanglong Airport	Jiuzhaigou
KAN	Africa/Lagos	Mallam Aminu International Airport	Kano
KAT	Pacific/Auckland	Kaitaia Airport	Kaitaia
KBP	Europe/Kiev	Boryspil International Airport	Kiev
KBV	Asia/Bangkok	Krabi Airport	Krabi
KCM	Europe/Istanbul	Kahramanmaras Airport	Kahramanmaras
KCZ	Asia/Tokyo	Kochi Airport (Gao Zhi Kong Gang )	Nankoku
KEF	Atlantic/Reykjavik	Keflavik International Airport	Reykjavik
KGS	Europe/Athens	Kos Airport	Kos Island
KHI	Asia/Karachi	Jinnah International Airport	Karachi
KHN	Asia/Shanghai	Nanchang Changbei International Airport	Nanchang
KHV	Asia/Vladivostok	Khabarovsk-Novy Airport	Khabarovsk
KIJ	Asia/Tokyo	Niigata Airport	Niigata
KIN	America/Jamaica	Norman Manley International Airport	Kingston
KIV	Europe/Chisinau	Chisinau International Airport	Chisinau
KIX	Asia/Tokyo	Kansai International Airport	Osaka
KKC	Asia/Bangkok	Khon Kaen Airport	Khon Kaen
KKE	Pacific/Auckland	Kerikeri Airport	Kerikeri
KKJ	Asia/Tokyo	Kitakyushu Airport	Kitakyushu
KKN	Europe/Oslo	Kirkenes Airport (Hoybuktmoen)	Kirkenes
KLR	Europe/Stockholm	Kalmar Airport	
KLU	Europe/Vienna	Klagenfurt Airport	Klagenfurt am Worthersee
KMG	Asia/Shanghai	Kunming Changshui International Airport	Kunming
KMI	Asia/Tokyo	Miyazaki Airport	Miyazaki
KMJ	Asia/Tokyo	Kumamoto Airport	Kumamoto
KMQ	Asia/Tokyo	Komatsu Airport	Kanazawa
KOA	Pacific/Honolulu	Ellison Onizuka Kona International At Keahole Airport	Kailua/Kona
KOJ	Asia/Tokyo	Kagoshima Airport	Kagoshima
KPO	Asia/Seoul	Pohang Airport (G-815/K-3)	Pohang
KRK	Europe/Warsaw	Krakow John Paul II International Airport	Krakow
KRN	Europe/Stockholm	Kiruna Airport	Kiruna
KRR	Europe/Moscow	Krasnodar Pashkovsky International Airport	Krasnodar
KRS	Europe/Oslo	Kristiansand Airport	Kjevik
KRT	Africa/Khartoum	Khartoum International Airport	Khartoum
KSC	Europe/Bratislava	Kosice Airport	Kosice
KSU	Europe/Oslo	Kristiansund Airport (Kvernberget)	Kvernberget
KSY	Europe/Istanbul	Kars Airport	Kars
KTM	Asia/Kathmandu	Tribhuvan International Airport	Kathmandu
KTW	Europe/Warsaw	Katowice International Airport	Katowice
KUF	Europe/Samara	Kurumoch International Airport	Samara
KUH	Asia/Tokyo	Kushiro Airport	Kushiro
KUL	Asia/Kuala_Lumpur	Kuala Lumpur International Airport	Kuala Lumpur
KUO	Europe/Helsinki	Kuopio Airport	Kuopio / Siilinjarvi
KVA	Europe/Athens	Alexander the Great International Airport	Kavala
KWE	Asia/Shanghai	Longdongbao Airport	Guiyang
KWI	Asia/Kuwait	Kuwait International Airport	Kuwait City
KWJ	Asia/Seoul	Gwangju Airport	Gwangju
KWL	Asia/Shanghai	Guilin Liangjiang International Airport	Guilin City
KYA	Europe/Istanbul	Konya Airport	Konya
KZN	Europe/Moscow	Kazan International Airport	Kazan
LAD	Africa/Luanda	Quatro de Fevereiro Airport	Luanda
LAN	America/Detroit	Capital City Airport	Lansing
LAS	America/Los_Angeles	McCarran International Airport	Las Vegas
LAX	America/Los_Angeles	Los Angeles International Airport	Los Angeles
LBA	Europe/London	Leeds Bradford Airport	Leeds
LCA	Asia/Nicosia	Larnaca International Airport	Larnarca
LCG	Europe/Madrid	A Coruna Airport	Culleredo
LCY	Europe/London	London City Airport	London
LED	Europe/Moscow	Pulkovo Airport	St. Petersburg
LEI	Europe/Madrid	Almeria International Airport	Almeria
LEJ	Europe/Berlin	Leipzig/Halle Airport	Leipzig
LEX	America/New_York	Blue Grass Airport	Lexington
LGA	America/New_York	La Guardia Airport	New York
LGB	America/Los_Angeles	Long Beach /Daugherty Field/ Airport	Long Beach
LGW	Europe/London	London Gatwick Airport	London
LHE	Asia/Karachi	Alama Iqbal International Airport	Lahore
LHR	Europe/London	London Heathrow Airport	London
LHW	Asia/Shanghai	Lanzhou Zhongchuan Airport	Lanzhou
LIH	Pacific/Honolulu	Lihue Airport	Lihue
LIM	America/Lima	Jorge Chavez International Airport	Lima
LIN	Europe/Rome	Milano Linate Airport	Milan
LIR	America/Costa_Rica	Daniel Oduber Quiros International Airport	Liberia
LIS	Europe/Lisbon	Humberto Delgado Airport (Lisbon Portela Airport)	Lisbon
LIT	America/Chicago	Bill & Hillary Clinton National Airport/Adams Field	Little Rock
LJG	Asia/Shanghai	Lijiang Airport	Lijiang
LJU	Europe/Ljubljana	Ljubljana Joze Pucnik Airport	Ljubljana
LLA	Europe/Stockholm	Lulea Airport	Lulea
LLW	Africa/Blantyre	Lilongwe International Airport	Lilongwe
LMT	America/Los_Angeles	Crater Lake-Klamath Regional Airport	Klamath Falls
LNK	America/Chicago	Lincoln Airport	Lincoln
LNZ	Europe/Vienna	Linz Horsching Airport	Linz
LOS	Africa/Lagos	Murtala Muhammed International Airport	Lagos
LPA	Atlantic/Canary	Gran Canaria Airport	Gran Canaria Island
LUG	Europe/Zurich	Lugano Airport	Lugano
LUN	Africa/Lusaka	Kenneth Kaunda International Airport	Lusaka
LUX	Europe/Luxembourg	Luxembourg-Findel International Airport	Luxembourg
LVI	Africa/Lusaka	Harry Mwanga Nkumbula International Airport	Livingstone
LWO	Europe/Uzhgorod	Lviv International Airport	Lviv
LXA	Asia/Urumqi	Lhasa Gonggar Airport	Lhasa
LXR	Africa/Cairo	Luxor International Airport	Luxor
LYH	America/New_York	Lynchburg Regional Preston Glenn Field	Lynchburg
LYI	Asia/Shanghai	Shubuling Airport	Linyi
LYR	Arctic/Longyearbyen	Svalbard Airport	NO-21
LYS	Europe/Paris	Lyon Saint-Exupery Airport	Lyon
LZH	Asia/Shanghai	Liuzhou Bailian Airport	Liuzhou
LZO	Asia/Shanghai	Luzhou Airport	Luzhou
LZY	Asia/Urumqi	Nyingchi Airport	Nyingchi
MAA	Asia/Kolkata	Chennai International Airport	Chennai
MAD	Europe/Madrid	Adolfo Suarez Madrid-Barajas Airport	Madrid
MAH	Europe/Madrid	Menorca Airport	Menorca Island
MAN	Europe/London	Manchester Airport	Manchester
MBE	Asia/Tokyo	Monbetsu Airport	Monbetsu
MBJ	America/Jamaica	Sangster International Airport	Montego Bay
MBS	America/Detroit	MBS International Airport	Saginaw
MCI	America/Chicago	Kansas City International Airport	Kansas City
MCO	America/New_York	Orlando International Airport	Orlando
MCT	Asia/Muscat	Muscat International Airport	Muscat
MDG	Asia/Shanghai	Mudanjiang Hailang International Airport	Mudanjiang
MDT	America/New_York	Harrisburg International Airport	Harrisburg
MED	Asia/Riyadh	Prince Mohammad Bin Abdulaziz Airport	Medina
MEL	Australia/Melbourne	Melbourne International Airport	Melbourne
MEM	America/Chicago	Memphis International Airport	Memphis
MEX	America/Mexico_City	Licenciado Benito Juarez International Airport	Mexico City
MFM	Asia/Macau	Macau International Airport	Macau
MFR	America/Los_Angeles	Rogue Valley International Medford Airport	Medford
MGM	America/Chicago	Montgomery Regional (Dannelly Field) Airport	Montgomery
MGW	America/New_York	Morgantown Municipal Walter L. Bill Hart Field	Morgantown
MHD	Asia/Tehran	Mashhad International Airport	Mashhad
MHG	Europe/Berlin	Mannheim-City Airport	Mannheim
MHT	America/New_York	Manchester-Boston Regional Airport	Manchester
MIA	America/New_York	Miami International Airport	Miami
MIG	Asia/Shanghai	Mianyang Airport	Mianyang
MIR	Africa/Tunis	Monastir Habib Bourguiba International Airport	Monastir
MJT	Europe/Athens	Mytilene International Airport	Mytilene
MKE	America/Chicago	General Mitchell International Airport	Milwaukee
MLA	Europe/Malta	Malta International Airport	Valletta
MLE	Indian/Maldives	Male International Airport	Male
MLI	America/Chicago	Quad City International Airport	Moline
MLX	Europe/Istanbul	Malatya Erhac Airport	Malatya
MMB	Asia/Tokyo	Memanbetsu Airport	Ozora
MMX	Europe/Stockholm	Malmo Sturup Airport	Malmo
MMY	Asia/Tokyo	Miyako Airport	Miyako City
MNL	Asia/Manila	Ninoy Aquino International Airport	Manila
MOB	America/Chicago	Mobile Regional Airport	Mobile
MOD	America/Los_Angeles	Modesto City Co-Harry Sham Field	Modesto
MOL	Europe/Oslo	Molde Airport	Aro
MPM	Africa/Maputo	Maputo Airport	Maputo
MQM	Europe/Istanbul	Mardin Airport	Mardin
MRO	Pacific/Auckland	Hood Airport	Masterton
MRS	Europe/Paris	Marseille Provence Airport	Marseille
MRU	Indian/Mauritius	Sir Seewoosagur Ramgoolam International Airport	Port Louis
MRY	America/Los_Angeles	Monterey Peninsula Airport	Monterey
MSN	America/Chicago	Dane County Regional Truax Field	Madison
MSO	America/Denver	Missoula International Airport	Missoula
MSP	America/Chicago	Minneapolis-St Paul International/Wold-Chamberlain Airport	Minneapolis
MSR	Europe/Istanbul	Mus Airport	Mus
MSY	America/Chicago	Louis Armstrong New Orleans International Airport	New Orleans
MTJ	America/Denver	Montrose Regional Airport	Montrose
MUC	Europe/Berlin	Munich Airport	Munich
MUH	Africa/Cairo	Mersa Matruh Airport	Mersa Matruh
MVY	America/New_York	Martha's Vineyard Airport	Martha's Vineyard
MWH	America/Los_Angeles	Grant County International Airport	Moses Lake
MWX	Asia/Seoul	Muan International Airport	Piseo-ri (Muan)
MXP	Europe/Rome	Malpensa International Airport	Milan
MYE	Asia/Tokyo	Miyakejima Airport	Miyakejima
MYJ	Asia/Tokyo	Matsuyama Airport	Matsuyama
MYR	America/New_York	Myrtle Beach International Airport	Myrtle Beach
MZH	Europe/Istanbul	Amasya Merzifon Airport	Amasya
MZT	America/Mazatlan	General Rafael Buelna International Airport	Mazatlan
NAN	Pacific/Fiji	Nadi International Airport	Nadi
NAP	Europe/Rome	Naples International Airport	Napoli
NAS	America/Nassau	Lynden Pindling International Airport	Nassau
NAT	America/Fortaleza	Governador Aluizio Alves International Airport	Natal
NAV	Europe/Istanbul	Nevsehir Kapadokya Airport	Nevsehir
NBO	Africa/Nairobi	Jomo Kenyatta International Airport	Nairobi
NCE	Europe/Paris	Nice-Cote d'Azur Airport	Nice
NCL	Europe/London	Newcastle Airport	Newcastle
NDG	Asia/Shanghai	Qiqihar Sanjiazi Airport	Qiqihar
NGB	Asia/Shanghai	Ningbo Lishe International Airport	Ningbo
NGO	Asia/Tokyo	Chubu Centrair International Airport	Tokoname
NGS	Asia/Tokyo	Nagasaki Airport	Nagasaki
NKG	Asia/Shanghai	Nanjing Lukou Airport	Nanjing
NLK	Pacific/Norfolk	Norfolk Island International Airport	Burnt Pine
NNG	Asia/Shanghai	Nanning Wuxu Airport	Nanning
NOU	Pacific/Noumea	La Tontouta International Airport	Noumea
NPE	Pacific/Auckland	Hawke's Bay Airport	Napier
NPL	Pacific/Auckland	New Plymouth Airport	New Plymouth
NQY	Europe/London	Newquay Cornwall Airport	Newquay
NRT	Asia/Tokyo	Narita International Airport	Tokyo
NSN	Pacific/Auckland	Nelson Airport	Nelson
NTG	Asia/Shanghai	Nantong Airport	Nantong
NTQ	Asia/Tokyo	Noto Airport	Wajima
NUE	Europe/Berlin	Nuremberg Airport	Nuremberg
NWI	Europe/London	Norwich International Airport	Norwich
OAJ	America/New_York	Albert J Ellis Airport	Jacksonville
OAK	America/Los_Angeles	Metropolitan Oakland International Airport	Oakland
OAM	Pacific/Auckland	Oamaru Airport	
ODS	Europe/Simferopol	Odessa International Airport	Odessa
OGG	Pacific/Honolulu	Kahului Airport	Kahului
OHD	Europe/Skopje	Ohrid St. Paul the Apostle Airport	Ohrid
OIM	Asia/Tokyo	Oshima Airport	Izu Oshima
OIT	Asia/Tokyo	Oita Airport	Oita
OKA	Asia/Tokyo	Naha Airport	Naha
OKC	America/Chicago	Will Rogers World Airport	Oklahoma City
OKD	Asia/Tokyo	Okadama Airport	Sapporo
OKJ	Asia/Tokyo	Okayama Airport	Okayama City
OLB	Europe/Rome	Olbia Costa Smeralda Airport	Olbia (SS)
OMA	America/Chicago	Eppley Airfield	Omaha
ONJ	Asia/Tokyo	Odate Noshiro Airport	Odate
ONT	America/Los_Angeles	Ontario International Airport	Ontario
OOL	Australia/Brisbane	Gold Coast Airport	Gold Coast
OPO	Europe/Lisbon	Francisco de Sa Carneiro Airport	Porto
ORD	America/Chicago	Chicago O'Hare International Airport	Chicago
ORF	America/New_York	Norfolk International Airport	Norfolk
ORY	Europe/Paris	Paris-Orly Airport	Paris
OSD	Europe/Stockholm	Are Ostersund Airport	Ostersund
OSI	Europe/Zagreb	Osijek Airport	Osijek
OSL	Europe/Oslo	Oslo Gardermoen Airport	Oslo
OTH	America/Los_Angeles	Southwest Oregon Regional Airport	North Bend
OTP	Europe/Bucharest	Henri Coanda International Airport	Bucharest
OUL	Europe/Helsinki	Oulu Airport	Oulu / Oulunsalo
OVD	Europe/Madrid	Asturias Airport	Ranon
OXB	Africa/Bissau	Osvaldo Vieira International Airport	Bissau
OXR	America/Los_Angeles	Oxnard Airport	Oxnard
PAD	Europe/Berlin	Paderborn Lippstadt Airport	Paderborn
PAP	America/Port-au-Prince	Toussaint Louverture International Airport	Port-au-Prince
PBI	America/New_York	Palm Beach International Airport	West Palm Beach
PDL	Atlantic/Azores	Joao Paulo II Airport	Ponta Delgada
PDX	America/Los_Angeles	Portland International Airport	Portland
PEK	Asia/Shanghai	Beijing Capital International Airport	Beijing
PEN	Asia/Kuala_Lumpur	Penang International Airport	Penang
PER	Australia/Perth	Perth International Airport	Perth
PGV	America/New_York	Pitt Greenville Airport	Greenville
PHF	America/New_York	Newport News Williamsburg International Airport	Newport News
PHL	America/New_York	Philadelphia International Airport	Philadelphia
PHS	Asia/Bangkok	Phitsanulok Airport	
PHX	America/Phoenix	Phoenix Sky Harbor International Airport	Phoenix
PIA	America/Chicago	General Wayne A. Downing Peoria International Airport	Peoria
PIT	America/New_York	Pittsburgh International Airport	Pittsburgh
PIX	Atlantic/Azores	Pico Airport	Pico Island
PKB	America/New_York	Mid Ohio Valley Regional Airport	Parkersburg
PLQ	Europe/Vilnius	Palanga International Airport	Palanga
PLS	America/Grand_Turk	Providenciales Airport	Providenciales Island
PLZ	Africa/Johannesburg	Port Elizabeth Airport	Port Elizabeth
PMI	Europe/Madrid	Palma De Mallorca Airport	Palma De Mallorca
PMO	Europe/Rome	Falcone-Borsellino Airport	Palermo
PMR	Pacific/Auckland	Palmerston North Airport	
PNA	Europe/Madrid	Pamplona Airport	Pamplona
PNH	Asia/Phnom_Penh	Phnom Penh International Airport	Phnom Penh
PNQ	Asia/Kolkata	Pune Airport	Pune
PNS	America/Chicago	Pensacola International Airport	Pensacola
POP	America/Santo_Domingo	Gregorio Luperon International Airport	Puerto Plata
POZ	Europe/Warsaw	Poznan-Lawica Airport	Poznan
PPT	Pacific/Tahiti	Faa'a International Airport	Papeete
PQI	America/New_York	Presque Isle International Airport	Presque Isle
PRG	Europe/Prague	Vaclav Havel Airport Prague	Prague
PRN	Europe/Belgrade	Pristina International Airport	Prishtina
PSA	Europe/Rome	Pisa International Airport	Pisa
PSC	America/Los_Angeles	Tri Cities Airport	Pasco
PSP	America/Los_Angeles	Palm Springs International Airport	Palm Springs
PTP	America/Guadeloupe	Pointe-a-Pitre Le Raizet	Pointe-a-Pitre
PUJ	America/Santo_Domingo	Punta Cana International Airport	Punta Cana
PUS	Asia/Seoul	Gimhae International Airport	Busan
PUY	Europe/Zagreb	Pula Airport	Pula
PVD	America/New_York	Theodore Francis Green State Airport	Providence
PVG	Asia/Shanghai	Shanghai Pudong International Airport	Shanghai
PVK	Europe/Athens	Aktion National Airport	Preveza/Lefkada
PVR	America/Mexico_City	Licenciado Gustavo Diaz Ordaz International Airport	Puerto Vallarta
PWM	America/New_York	Portland International Jetport	Portland
PXO	Atlantic/Madeira	Porto Santo Airport	Vila Baleira
PZI	Asia/Shanghai	Bao'anying Airport	Panzhihua
RAI	Atlantic/Cape_Verde	Praia International Airport	Praia
RAP	America/Denver	Rapid City Regional Airport	Rapid City
RAR	Pacific/Rarotonga	Rarotonga International Airport	Avarua
RDD	America/Los_Angeles	Redding Municipal Airport	Redding
RDM	America/Los_Angeles	Roberts Field	Redmond
RDU	America/New_York	Raleigh Durham International Airport	Raleigh/Durham
REC	America/Recife	Guararapes - Gilberto Freyre International Airport	Recife
REP	Asia/Phnom_Penh	Siem Reap International Airport	Siem Reap
RGN	Asia/Yangon	Yangon International Airport	Yangon
RHO	Europe/Athens	Diagoras Airport	Rodes Island
RIC	America/New_York	Richmond International Airport	Richmond
RIS	Asia/Tokyo	Rishiri Airport	Rishiri
RIX	Europe/Riga	Riga International Airport	Riga
RJK	Europe/Zagreb	Rijeka Airport	Rijeka
RKS	America/Denver	Southwest Wyoming Regional Airport	Rock Springs
RMF	Africa/Cairo	Marsa Alam International Airport	Marsa Alam
RNB	Europe/Stockholm	Ronneby Airport	
RNO	America/Los_Angeles	Reno Tahoe International Airport	Reno
ROA	America/New_York	Roanoke-Blacksburg Regional Airport	Roanoke
ROC	America/New_York	Greater Rochester International Airport	Rochester
ROR	Pacific/Palau	Babelthuap Airport	Babelthuap Island
ROT	Pacific/Auckland	Rotorua Regional Airport	Rotorua
ROV	Europe/Moscow	Platov International Airport	Rostov-on-Don
RSU	Asia/Seoul	Yeosu Airport	Yeosu
RSW	America/New_York	Southwest Florida International Airport	Fort Myers
RUH	Asia/Riyadh	King Khaled International Airport	Riyadh
RZE	Europe/Warsaw	Rzeszow-Jasionka Airport	Rzeszow
SAH	Asia/Aden	Sana'a International Airport	Sana'a
SAN	America/Los_Angeles	San Diego International Airport	San Diego
SAT	America/Chicago	San Antonio International Airport	San Antonio
SAV	America/New_York	Savannah Hilton Head International Airport	Savannah
SAW	Europe/Istanbul	Sabiha Gokcen International Airport	Istanbul
SBA	America/Los_Angeles	Santa Barbara Municipal Airport	Santa Barbara
SBN	America/Indiana/Indianapolis	South Bend Regional Airport	South Bend
SBP	America/Los_Angeles	San Luis County Regional Airport	San Luis Obispo
SBY	America/New_York	Salisbury Ocean City Wicomico Regional Airport	Salisbury
SBZ	Europe/Bucharest	Sibiu International Airport	Sibiu
SCE	America/New_York	University Park Airport	State College
SCL	America/Santiago	Comodoro Arturo Merino Benitez International Airport	Santiago
SCN	Europe/Berlin	Saarbrucken Airport	Saarbrucken
SCQ	Europe/Madrid	Santiago de Compostela Airport	Santiago de Compostela
SDF	America/Kentucky/Louisville	Louisville Muhammad Ali International Airport	Louisville
SDJ	Asia/Tokyo	Sendai Airport	Sendai
SDL	Europe/Stockholm	Sundsvall-Harnosand Airport	Sundsvall/ Harnosand
SDQ	America/Santo_Domingo	Las Americas International Airport	Santo Domingo
SEA	America/Los_Angeles	Seattle Tacoma International Airport	Seattle
SFO	America/Los_Angeles	San Francisco International Airport	San Francisco
SFT	Europe/Stockholm	Skelleftea Airport	Skelleftea
SGF	America/Chicago	Springfield Branson National Airport	Springfield
SGN	Asia/Ho_Chi_Minh	Tan Son Nhat International Airport	Ho Chi Minh City
SHA	Asia/Shanghai	Shanghai Hongqiao International Airport	Shanghai
SHB	Asia/Tokyo	Nakashibetsu Airport	Nakashibetsu
SHD	America/New_York	Shenandoah Valley Regional Airport	Staunton/Waynesboro/Harrisonburg
SHE	Asia/Shanghai	Taoxian Airport	Shenyang
SHJ	Asia/Dubai	Sharjah International Airport	Sharjah
SHP	Asia/Shanghai	Qinhuangdao Shanhaiguan Airport	Qinhuangdao
SIC	America/Panama	San Jose Island Airport	Las Perlas
SID	Atlantic/Cape_Verde	Amilcar Cabral International Airport	Espargos
SIN	Asia/Singapore	Singapore Changi Airport	Singapore
SIP	Europe/Simferopol	Simferopol International Airport	Simferopol
SJC	America/Los_Angeles	Norman Y. Mineta San Jose International Airport	San Jose
SJD	America/Mazatlan	Los Cabos International Airport	San Jose del Cabo
SJJ	Europe/Sarajevo	Sarajevo International Airport	Sarajevo
SJO	America/Costa_Rica	Juan Santamaria International Airport	San Jose
SJU	America/Puerto_Rico	Luis Munoz Marin International Airport	San Juan
SJW	Asia/Shanghai	Shijiazhuang Daguocun International Airport	Shijiazhuang
SKB	America/St_Kitts	Robert L. Bradshaw International Airport	Basseterre
SKG	Europe/Athens	Thessaloniki Macedonia International Airport	Thessaloniki
SKP	Europe/Skopje	Skopje International Airport	Skopje
SLC	America/Denver	Salt Lake City International Airport	Salt Lake City
SMF	America/Los_Angeles	Sacramento International Airport	Sacramento
SMI	Europe/Athens	Samos Airport	Samos Island
SMX	America/Los_Angeles	Santa Maria Pub/Capt G Allan Hancock Field	Santa Maria
SNA	America/Los_Angeles	John Wayne Airport-Orange County Airport	Santa Ana
SNN	Europe/Dublin	Shannon Airport	Shannon
SNU	America/Havana	Abel Santamaria Airport	Santa Clara
SOB	Europe/Budapest	Heviz-Balaton Airport	Sarmellek
SOF	Europe/Sofia	Sofia Airport	Sofia
SPI	America/Chicago	Abraham Lincoln Capital Airport	Springfield
SPN	Pacific/Saipan	Saipan International Airport	Saipan Island
SPU	Europe/Zagreb	Split Airport	Split
SRQ	America/New_York	Sarasota Bradenton International Airport	Sarasota/Bradenton
SSA	America/Bahia	Deputado Luiz Eduardo Magalhaes International Airport	Salvador
SSH	Africa/Cairo	Sharm El Sheikh International Airport	Sharm el-Sheikh
STL	America/Chicago	St Louis Lambert International Airport	St Louis
STN	Europe/London	London Stansted Airport	London
STR	Europe/Berlin	Stuttgart Airport	Stuttgart
STT	America/St_Thomas	Santo Tomas Airport	Suchiate
STX	America/St_Thomas	Henry E Rohlsen Airport	Christiansted
SUF	Europe/Rome	Lamezia Terme Airport	Lamezia Terme (CZ)
SVG	Europe/Oslo	Stavanger Airport Sola	Stavanger
SVO	Europe/Moscow	Sheremetyevo International Airport	Moscow
SVQ	Europe/Madrid	Sevilla Airport	Sevilla
SVX	Asia/Yekaterinburg	Koltsovo Airport	Yekaterinburg
SWA	Asia/Shanghai	Jieyang Chaoshan International Airport	Shantou
SWF	America/New_York	New York Stewart International Airport	Newburgh
SXF	Europe/Berlin	Berlin-Schonefeld Airport	Berlin
SXM	America/Lower_Princes	Princess Juliana International Airport	Saint Martin
SYD	Australia/Sydney	Sydney Kingsford Smith International Airport	Sydney
SYO	Asia/Tokyo	Shonai Airport	Shonai
SYR	America/New_York	Syracuse Hancock International Airport	Syracuse
SYX	Asia/Shanghai	Sanya Phoenix International Airport	Sanya
SZF	Europe/Istanbul	Samsun Carsamba Airport	Samsun
SZG	Europe/Vienna	Salzburg Airport	Salzburg
SZX	Asia/Shanghai	Shenzhen Bao'an International Airport	Shenzhen
SZZ	Europe/Warsaw	Szczecin-Goleniow ""Solidarnosc"" Airport	Goleniow
TAE	Asia/Seoul	Daegu Airport	Daegu
TAK	Asia/Tokyo	Takamatsu Airport	Takamatsu
TAO	Asia/Shanghai	Liuting Airport	Qingdao
TAS	Asia/Tashkent	Tashkent International Airport	Tashkent
TBS	Asia/Tbilisi	Tbilisi International Airport	Tbilisi
TBU	Pacific/Tongatapu	Fua'amotu International Airport	Nuku'alofa
TBZ	Asia/Tehran	Tabriz International Airport	Tabriz
TER	Atlantic/Azores	Lajes Airport	Praia da Vitoria
TFN	Atlantic/Canary	Tenerife Norte Airport	Tenerife Island
TFS	Atlantic/Canary	Tenerife South Airport	Tenerife Island
TGD	Europe/Podgorica	Podgorica Airport	Podgorica
TGO	Asia/Shanghai	Tongliao Airport	Tongliao
TIA	Europe/Tirane	Tirana International Airport Mother Teresa	Tirana
TIP	Africa/Tripoli	Tripoli International Airport	Tripoli
TIU	Pacific/Auckland	Timaru Airport	
TKS	Asia/Tokyo	Tokushima Airport/JMSDF Air Base	Tokushima
TKU	Europe/Helsinki	Turku Airport	Turku
TLH	America/New_York	Tallahassee Regional Airport	Tallahassee
TLL	Europe/Tallinn	Lennart Meri Tallinn Airport	Tallinn
TLS	Europe/Paris	Toulouse-Blagnac Airport	Toulouse/Blagnac
TLV	Asia/Jerusalem	Ben Gurion International Airport	Tel Aviv
TMP	Europe/Helsinki	Tampere-Pirkkala Airport	Tampere / Pirkkala
TMS	Africa/Sao_Tome	Sao Tome International Airport	Sao Tome
TNA	Asia/Shanghai	Yaoqiang Airport	Jinan
TOS	Europe/Oslo	Tromso Airport	Tromso
TOY	Asia/Tokyo	Toyama Airport	Toyama
TPA	America/New_York	Tampa International Airport	Tampa
TPE	Asia/Taipei	Taiwan Taoyuan International Airport	Taipei
TRD	Europe/Oslo	Trondheim Airport Vaernes	Trondheim
TRF	Europe/Oslo	Sandefjord Airport	NO-07
TRG	Pacific/Auckland	Tauranga Airport	Tauranga
TRI	America/New_York	Tri-Cities Regional TN/VA Airport	Bristol/Johnson/Kingsport
TRN	Europe/Rome	Turin Airport	Torino
TRS	Europe/Rome	Trieste-Friuli Venezia Giulia Airport	Trieste
TSA	Asia/Taipei	Taipei Songshan Airport	Taipei City
TSE	Asia/Almaty	Astana International Airport	Astana
TSJ	Asia/Tokyo	Tsushima Airport	Tsushima
TSN	Asia/Shanghai	Tianjin Binhai International Airport	Tianjin
TSR	Europe/Bucharest	Timisoara Traian Vuia Airport	Timisoara
TTJ	Asia/Tokyo	Tottori Airport	Tottori
TUL	America/Chicago	Tulsa International Airport	Tulsa
TUN	Africa/Tunis	Tunis Carthage International Airport	Tunis
TUO	Pacific/Auckland	Taupo Airport	Taupo
TUS	America/Phoenix	Tucson International Airport	Tucson
TVC	America/Detroit	Cherry Capital Airport	Traverse City
TXL	Europe/Berlin	Berlin-Tegel Airport	Berlin
TXN	Asia/Shanghai	Tunxi International Airport	Huangshan
TYN	Asia/Shanghai	Taiyuan Wusu Airport	Taiyuan
TYS	America/New_York	McGhee Tyson Airport	Knoxville
TZX	Europe/Istanbul	Trabzon International Airport	Trabzon
UBJ	Asia/Tokyo	Yamaguchi Ube Airport	Ube
UBP	Asia/Bangkok	Ubon Ratchathani Airport	Ubon Ratchathani
UFA	Asia/Yekaterinburg	Ufa International Airport	Ufa
UKB	Asia/Tokyo	Kobe Airport	Kobe
ULN	Asia/Ulaanbaatar	Chinggis Khaan International Airport	Ulan Bator
UME	Europe/Stockholm	Umea Airport	Umea
URC	Asia/Urumqi	Urumqi Diwopu International Airport	Urumqi
URT	Asia/Bangkok	Surat Thani Airport	Surat Thani
USM	Asia/Bangkok	Samui Airport	Na Thon (Ko Samui Island)
USN	Asia/Seoul	Ulsan Airport	Ulsan
USQ	Europe/Istanbul	Usak Airport	Usak
UTH	Asia/Bangkok	Udon Thani Airport	Udon Thani
UUS	Asia/Sakhalin	Yuzhno-Sakhalinsk Airport	Yuzhno-Sakhalinsk
UVF	America/St_Lucia	Hewanorra International Airport	Vieux Fort
VAA	Europe/Helsinki	Vaasa Airport	Vaasa
VAN	Europe/Istanbul	Van Ferit Melen Airport	Van
VAR	Europe/Sofia	Varna Airport	Varna
VAS	Europe/Istanbul	Sivas Nuri Demirag Airport	Sivas
VCE	Europe/Rome	Venice Marco Polo Airport	Venice
VFA	Africa/Harare	Victoria Falls International Airport	Victoria Falls
VGO	Europe/Madrid	Vigo Airport	Vigo
VIE	Europe/Vienna	Vienna International Airport	Vienna
VLC	Europe/Madrid	Valencia Airport	Valencia
VLI	Pacific/Efate	Bauerfield International Airport	Port Vila
VNO	Europe/Vilnius	Vilnius International Airport	Vilnius
VPS	America/Chicago	Destin-Ft Walton Beach Airport	Valparaiso
VRA	America/Havana	Juan Gualberto Gomez International Airport	Varadero
VRN	Europe/Rome	Verona Villafranca Airport	Verona
VTE	Asia/Vientiane	Wattay International Airport	Vientiane
WAG	Pacific/Auckland	Wanganui Airport	Wanganui
WAW	Europe/Warsaw	Warsaw Chopin Airport	Warsaw
WDH	Africa/Windhoek	Hosea Kutako International Airport	Windhoek
WEH	Asia/Shanghai	Weihai Airport	Weihai
WHK	Pacific/Auckland	Whakatane Airport	
WKA	Pacific/Auckland	Wanaka Airport	
WKJ	Asia/Tokyo	Wakkanai Airport	Wakkanai
WLG	Pacific/Auckland	Wellington International Airport	Wellington
WNZ	Asia/Shanghai	Wenzhou Longwan International Airport	Wenzhou
WRE	Pacific/Auckland	Whangarei Airport	
WRO	Europe/Warsaw	Copernicus Wroclaw Airport	Wroclaw
WSZ	Pacific/Auckland	Westport Airport	
WUH	Asia/Shanghai	Wuhan Tianhe International Airport	Wuhan
WUS	Asia/Shanghai	Nanping Wuyishan Airport	Wuyishan
WUX	Asia/Shanghai	Sunan Shuofang International Airport	Wuxi
WXN	Asia/Shanghai	Wanxian Airport	Wanxian
XFN	Asia/Shanghai	Xiangyang Liuji Airport	Xiangfan
XIC	Asia/Shanghai	Xichang Qingshan Airport	Xichang
XIL	Asia/Shanghai	Xilinhot Airport	Xilinhot
XIY	Asia/Shanghai	Xi'an Xianyang International Airport	Xi'an
XMN	Asia/Shanghai	Xiamen Gaoqi International Airport	Xiamen
XNA	America/Chicago	Northwest Arkansas Regional Airport	Fayetteville/Springdale/Rogers
XNN	Asia/Shanghai	Xining Caojiabu Airport	Xining
XRY	Europe/Madrid	Jerez Airport	Jerez de la Forntera
XUZ	Asia/Shanghai	Xuzhou Guanyin Airport	Xuzhou
YAM	America/Toronto	Sault Ste Marie Airport	Sault Ste Marie
YBC	America/Toronto	Baie Comeau Airport	Baie-Comeau
YBG	America/Toronto	CFB Bagotville	Bagotville
YBP	Asia/Shanghai	Yibin Caiba Airport	Yibin
YCD	America/Vancouver	Nanaimo Airport	Nanaimo
YCG	America/Vancouver	Castlegar/West Kootenay Regional Airport	Castlegar
YCU	Asia/Shanghai	Yuncheng Guangong Airport	Yuncheng
YDF	America/St_Johns	Deer Lake Airport	Deer Lake
YEG	America/Edmonton	Edmonton International Airport	Edmonton
YFC	America/Moncton	Fredericton Airport	Fredericton
YGJ	Asia/Tokyo	Miho Yonago Airport	Yonago
YGK	America/Toronto	Kingston Norman Rogers Airport	Kingston
YGP	America/Toronto	Gaspe (Michel-Pouliot) Airport	Gaspe
YGR	America/Halifax	Iles-de-la-Madeleine Airport	Iles-de-la-Madeleine
YHZ	America/Halifax	Halifax / Stanfield International Airport	Halifax
YIH	Asia/Shanghai	Yichang Sanxia Airport	Yichang
YKA	America/Vancouver	Kamloops Airport	Kamloops
YLW	America/Vancouver	Kelowna International Airport	Kelowna
YMM	America/Edmonton	Fort McMurray Airport	Fort McMurray
YNJ	Asia/Shanghai	Yanji Chaoyangchuan Airport	Yanji
YNT	Asia/Shanghai	Duplicate --Yantai Penglai International Airport	Yantai
YNZ	Asia/Shanghai	Yancheng Airport	Yancheng
YOW	America/Toronto	Ottawa Macdonald-Cartier International Airport	Ottawa
YPR	America/Vancouver	Prince Rupert Airport	Prince Rupert
YQB	America/Toronto	Quebec Jean Lesage International Airport	Quebec
YQG	America/Toronto	Windsor Airport	Windsor
YQL	America/Edmonton	Lethbridge County Airport	Lethbridge
YQM	America/Moncton	Greater Moncton Romeo LeBlanc International Airport	Moncton
YQR	America/Regina	Regina International Airport	Regina
YQT	America/Thunder_Bay	Thunder Bay Airport	Thunder Bay
YQU	America/Edmonton	Grande Prairie Airport	Grande Prairie
YQX	America/St_Johns	Gander International Airport	Gander
YQY	America/Glace_Bay	Sydney / J.A. Douglas McCurdy Airport	Sydney
YSB	America/Toronto	Sudbury Airport	Sudbury
YSJ	America/Moncton	Saint John Airport	Saint John
YTS	America/Toronto	Timmins/Victor M. Power	Timmins
YUL	America/Toronto	Montreal / Pierre Elliott Trudeau International Airport	Montreal
YUM	America/Phoenix	Yuma MCAS/Yuma International Airport	Yuma
YUY	America/Toronto	Rouyn Noranda Airport	Rouyn-Noranda
YVO	America/Toronto	Val-d'Or Airport	Val-d'Or
YVR	America/Vancouver	Vancouver International Airport	Vancouver
YWG	America/Winnipeg	Winnipeg / James Armstrong Richardson International Airport	Winnipeg
YXC	America/Edmonton	Cranbrook/Canadian Rockies International Airport	Cranbrook
YXE	America/Regina	Saskatoon John G. Diefenbaker International Airport	Saskatoon
YXH	America/Edmonton	Medicine Hat Airport	Medicine Hat
YXJ	America/Dawson_Creek	Fort St John Airport	Fort St.John
YXS	America/Vancouver	Prince George Airport	Prince George
YXT	America/Vancouver	Northwest Regional Airport Terrace-Kitimat	Terrace
YXU	America/Toronto	London Airport	London
YXY	America/Whitehorse	Whitehorse / Erik Nielsen International Airport	Whitehorse
YYB	America/Toronto	North Bay Jack Garland Airport	North Bay
YYC	America/Edmonton	Calgary International Airport	Calgary
YYD	America/Vancouver	Smithers Airport	Smithers
YYF	America/Vancouver	Penticton Airport	Penticton
YYG	America/Halifax	Charlottetown Airport	Charlottetown
YYJ	America/Vancouver	Victoria International Airport	Victoria
YYR	America/Goose_Bay	Goose Bay Airport	Goose Bay
YYT	America/St_Johns	St. John's International Airport	St. John's
YYY	America/Toronto	Mont Joli Airport	Mont-Joli
YYZ	America/Toronto	Lester B. Pearson International Airport	Toronto
YZF	America/Yellowknife	Yellowknife Airport	Yellowknife
YZP	America/Vancouver	Sandspit Airport	Sandspit
YZR	America/Toronto	Chris Hadfield Airport	Sarnia
ZAD	Europe/Zagreb	Zadar Airport	Zemunik (Zadar)
ZAG	Europe/Zagreb	Zagreb Airport	Zagreb
ZBF	America/Moncton	Bathurst Airport	Bathurst
ZIH	America/Mexico_City	Ixtapa Zihuatanejo International Airport	Ixtapa
ZLO	America/Mexico_City	Playa De Oro International Airport	Manzanillo
ZQN	Pacific/Auckland	Queenstown International Airport	Queenstown
ZRH	Europe/Zurich	Zurich Airport	Zurich
ZTH	Europe/Athens	Zakynthos International Airport ""Dionysios Solomos	Zakynthos Island
ZUH	Asia/Shanghai	Zhuhai Jinwan Airport	Zhuhai
